11111111111111111111
11CCCCCCCCCCCCCCCC11
11CCCCCCCCCCCCCCCC11
11CCCCCCCCCCCCCCCC11
11CCCCCCCCCCCCCCCC11
11CCCCCCCCCCCCCCCC11
1PCCCCCCCCCCCCCCCCE1
11CCCCCCCCCCCCCCCC11
11CCCCCCCCCCCCCCCC11
11CCCCCCCCCCCCCCCC11
11CCCCCCCCCCCCCCCC11
11CCCCCCCCCCCCCCCC11
11111111111111111111