11111111111111111111
1P0000E11CCCCCCCCCC1
110111111CCCCCCCCCC1
1WCWCWCW1CCCCCCCCCC1
1CCCCCCC1CCCCCCCCCC1
1WCWCWCW1CCCCCCCCCC1
1CCCCCCC1CCCCCCCCCC1
1WCWCWCW1CCCCCCCCCC1
1CCCCCCC1CCCCCCCCCC1
1WCWCWCW1CCCCCCCCCC1
1CCCCCCCCCCCCCCCCCC1
1WCWCWCW1CCCCCCCCCC1
11111111111111111111