11111111111111111111
1P000E111CCC1WWWWWW1
111011100CCCCCCWWWC1
100000001CCC1WCWWCC1
1WWWWWWW11111WCCCCC1
1WWWWWWW11111WCWWWC1
1CCCCCCC11111WCWWWC1
1CCCCCCC1WWWWWCWWWC1
1111C1111WCCCCCWCCC1
1CCCCWWWWWCWWWWWCCC1
1CWWWWWCCCCCCCCCCCC1
1CCCCCCCWWWWWWWWCCC1
11111111111111111111