11111111111111111111
1CCCCC1000CCCCCCCCC1
1CCCCC1011CCCCCCCCC1
1CCCCC0011CCCCCCCCC1
1CCCCC1011WWWWWWWWC1
1111111011WCCCCCCCC1
1P000000E1WCWWWWWWW1
1111111011WCCCCCCCC1
1CCCCC1011WWWWWWWWC1
1CCCCC0011CCCCCCCCC1
1CCCCC1011CCCCCCCCC1
1CCCCC1000CCCCCCCCC1
11111111111111111111