11111111111111111111
1P000001CCCCC11000C1
11111101CCCCC11011C1
1CCCC1011101111011C1
1CCCC0000000000011C1
1CCCC1011111011111C1
11111101E00101CCC1C1
10000001110101CCC1C1
10111100000100CCC1C1
1CCCC111111101CCC1C1
1CCCC1111111011111C1
1CCCC000000000000001
11111111111111111111