111111111111111111
1P0001C011111CC111
1111010000000CCCC1
1CCCC10011001CCCC1
1CCCC000E100111111
111110001100111111
1CCCC00000CCCCCCC1
1CCCC11111CCCCCCC1
111111111111111111