111111111111111111
111CC1111C0C1CC111
111CC11110001CC111
111001111C0C110011
11P000000000000E11
111001111C0C110011
111CC11110001CC111
111CC1111C0C1CC111
111111111111111111